00000000000000000000000000000000000000000000000000
00000000000000001111100000000000000000000000000000
00000000000000001111100000000000000000000000000000
00000000000000001111100000000000000000000000000000
00000000000000001111100000000000000000000000000000
00000000000000001111100000000000000000000000000000
00000000000000001111100000000000000000000000000000
00000000000000001111100000000000000000000000000000
00000000000000004444333330000000000000000000000000
00000000000000004444333330000000000000000000000000
00000000000000004444333330000000000000000000000000
00000000000000004444333330000000000000000000000000
00000000000000004444333330000000000000000000000000
00000000000000004444333330000000000000000000000000
00000000000000004444333330000000000000000000000000
00000000000000004444333330000000000000000000000000
00000000000000004444333330000000000000000000000000
00000000000000004444333330000000000000000000000000
00000000000000004444333330000000000000000000000000
00000000000000004444333330000000000000000000000000
00000000000000004444333330000000000000000000000000
00000000000000004444333330000000000000000000000000
00000000000000004444333330000000000000000000000000
00000000000000004444333330000000000000000000000000
00000000000000004444333330000000000000000000000000
00000000000000004444333330000000000000000000000000
00000000000000004444440000000000000000000000000000
00000000000000004444440000000000000000000000000000
00000000000000055555550000000000000000000000000000
00000000000000555555555500000000000000000000000000
00000000000000555555555500000000000000000000000000
00000000000000555555555500000000000000000000000000
00000000000000555555555500000000000000000000000000
00000000000000555555555500000000000000000000000000
00000000000000555555555500000000000000000000000000
00000000000000555555555500000000000000000000000000
00000000000000555555555500000000000000000000000000
00000000000000555555555500000000000000000000000000
00000000000000555555555500000000000000000000000000
00000000000000555555555500000000000000000000000000
00000000000000555555555500000000000000000000000000
00000000000000555555555500000000000000000000000000
00000000000000555555555500000000000000000000000000
00000000000000555555555500000000000000000000000000
00000000000000555555555500000000000000000000000000
00000000000000555555555500000000000000000000000000
00000000000000555555555500000000000000000000000000
00000000000000555555555500000000000000000000000000
00000000000000555555555500000000000000000000000000
00000000000000555555555500000000000000000000000000